
TILES
1:
{tile = Block(x, y)}
2:
{
tile = PlayerCharacter(KeyboardControls.Player1)
tile.Position = Vector2(x, y)
}
3:
{
tile = Shellcreeper()
tile.Position = Vector2(x, y)
}
4:
{tile = ExitPipe(x, y)}
5:
{
tile = Sidestepper()
tile.Position = Vector2(x, y)
}
6:
{tile = Brick(x, y)}

LEVEL
00000000050000000000000000003000
00000000000000000000000000000000
00000000000000000000000000000000
00000000000000000000000000000000
00000000000000000000000000000000
00000000000000000000000000000000
11111111111111000011111111111111
00000000000000000000000000000000
00000000000003000000000000000000
00000000000000000000000000000000
00000000000000000000000000000000
00000000111111111111111100000000
11110000000000000000000000001111
00000020000000000000000000000000
00000000000000000000000000000000
00000000000000000000000000000000
00000000000000000000000000000000
11111111111000000000011111111111
00000000000000000000000000000000
00000000000000000000000000000000
40000000000000000000000000000040
00000000000000000000000000000000
00000000000000000000000000000000
66666666666666666666666666666666
66666666666666666666666666666666